....................
....................
...........11.......
......111...........
....................
..111................
....................
.....1111111........
....................
11111111111111111111