.......................................
.....................1...1.............
...........11111111....................
......111...........11111....111.......
..........................1......1.....
..111....................1...1.........
........................1........1.....
.....1111111...........1............1..
......................1............11..
111111111111111111111111111111111111111